\bAch\b	Ich
\bAhnen\b	Ihnen
\bBann\b	Dann
\bBieter\b	Meter
\bElement\b	Clement
\bFahr\b	Jahr
\bFahren\b	Jahren
\bfegte	setzte
\bfein	sein
\bfette\b	setzte
\bfliegen\b	stiegen
\bFusel\b	Insel
\bHart\b	Harst
\blebten	letzten
\blegte	letzte
\bMr,	Mr.
\bMr\s	Mr. 
\bnicke\b	nickte
\bober\b	oder
\bSa√ü\b	Satz
\bSeht\b	Jetzt
\bTer\b	Der
\bver\b	der
\bvor!\b	dort
\bMir\b	Wir
