Ich so	Ach so
als im	als ich
bin im	bin ich
die seine	die feine
die seinen	die feinen
ein seines	ein feines
eine seine	eine feine
einen seinen	einen feinen
fürchte im	fürchte ich
hätte im	hätte ich
habe im	habe ich
er Tag	er lag
ihre seinen	ihre feinen
im bin	ich bin
im denke	ich denke
im fürchte	ich fürchte
im glaube	ich glaube
im muß	ich muß
im habe	ich habe
im hatte	ich hatte
im mich	ich mich
im mir	ich mir
las im	las ich
meinte im	meinte ich
möchte im	möchte ich
sagte im	sagte ich
